....G...............
...##..-.....C...C..
...##..G.....#####..
..G....-............
..###..-....##..GG..
..##................
...##.........##....
....###...........G.
....##......#.....#.
......###...........
...X................
...#..........##....
C.....C........##...
########..........1.
..................#.