....................
....G........C.1....
....-........###....
.....GC....C........
....###...###.......
...............G....
...C...........#....
.###.._......#......
....................
..C.........C.......
.####.##.#.###.#....
........G...........
.G....-....G...X....
-.GG.G....GGG..-....
....-....GG-GGG....-