....................
....................
...-......G.........
.........##.........
....-....##.........
-........##.........
.........##.........
..-......##.........
.....-...##.........
..-......##.........
-........##.........
..-......##.........
.....-...##........X
1........##........#
#........##.........