....................
................N...
....................
....................
....................
......G.......G.....
......-..CGGGO#..G..
.........#####...G..
.....-.......#......
.....GGO......#..G.X
.....###..G...#..G.#
...G......#...##..-.
...#...GC..#.1#..G..
.....#####..###...-.
