....G...............
...##..-.....E...J..
...##..G.....#####..
..G....-............
..###..-....##..GG..
..##................
...##.........##....
....###...........G.
....##.....#......#.
......###...........
...X........#.......
...#..........##....
J.....I........##...
########..........1.
..................#.