.--............---..
..........G.........
....G..------.......
...--..........--...
D................G..
####..G.G.G.G....###
.......G.G.GBG......
......--------......
...--...........--..
............##......
...G....H..........X
...#...###.......###
....................
.1..GGGGGGGG..GGGCGG
##..##.##.#.#.######
