....................
....G........G.1....
....-........###....
.....GH....A........
....###...###.......
...............G....
...C...........#....
.###.._......#......
....................
..C.........E.......
.####.##.#.###.#....
........G...........
NG....-....G...X....
-.GG.G....GGG..-....
....-....GG-GGG....-