....................
.......D..G.L....G..
.......######....-.G
.E.................-
.###................
....................
......G..J.K....X..G
.#....-..###....#..G
...................G
.##....E.I.........G
.....#.###......#..G
.1.....I....L.GGGIG.
.####..######.#####.
...##..######......#
.......###..........
