....................
....................
...-......G.........
.........##.........
....-....##..M......
-........##.---.....
.........##.........
..-..M...##......M..
.....--..##...G.----
..-......##..G......
-........##.--...GG.
..-......##.....-...
.....-...##........X
1........##........#
#........##.........