....................
....................
....................
....G...##....#.....
....#....#F..H#.....
..........#####.....
......G.......#.....
......#.......#.....
.........#####......
.....#.......#......
.....H.A......#.....
.....###...G..#.....
...........#..#....X
.....F.GG....1#....#
.....####....##.....