...................
.1#G................
..##................
.........IGGJ...G...
.......#.####..##...
....-...............
..........--..#-....
..-.......GG........
..........--...#....
..--...-..GG........
..........##...#....
..--.........#......
......--.....##EX...
..##...........##...
....................
