....................
....................
..J.....J...J..J....
..##############1...
................##..
.........GGG........
..J......GGG....GGGG
#####....GGG....####
.........###........
.....JGGGJ.....GGGGG
.....#####.....#####
....................
....................
XGGGJ...GGGGG...GGGG
#####...#####...####