....................
................N...
....................
....................
....................
......G.......G.....
......-..CGGGC#..G..
.........#####...G..
.....-.......#......
.....GGO......#..G.X
.....###...G..#..G.#
...G.......#..##..-.
...#.O.GO....1#..G..
.....####....##...-.
