................X...
................-...
.....C..............
.....###.....##....
..G..............G..
####..G.G.G.G....###
.......G.G.GCG......
......--------......
...--...........--..
......GGGG.GGGG.....
...G.G...GG..G....G.
..####.GG..GGGG.####
....................
.1..................
....................
