...................
.1#G................
..##................
.........CGGC...G...
.......#.####..##...
....-...............
..........--..#-....
..-.......GG........
..........--...#....
..--...-..GG........
..........##...#....
..--.........#......
......--.....##CX...
..##...........##...
....................
