....................
........G.....CGGGC.
........#.....#----.
.......-............
..................-#
.......-......GGGC..
.......G......####..
.......-.....#.##..G
.......CGGGC....#..-
.......#####....#G..
.................#..
.....-....GGC..###..
...-......###.......
1................CGX
###.#.#.#........###
