....................
....................
..CGGGGGCGGGCGGC....
..##############1...
................##..
.........GGG........
..C......GGG....GGGC
#####....GGG....####
.........###........
.....CGGGC.....CGGGC
.....#####.....#####
....................
....................
XGGGC...CGGGC...GC.C
#####...#####...####

Should be FOH