....................
....................
....................
....................
.....G..............
.....#..............
....GC..............
...###....#.........
........#.......G...
..G......C..........
..#....###..........
...C..........C..X..
..##..........####.
.....C.1............
.....###............