.--.................
..........X.........
.......------.......
...--..........--...
..G..............G..
####..G.G.G.G....###
.......G.G.GBG......
......--------......
...--...........--..
....................
AG.G.D..............
##########..........
....................
.1..GGGGGGGG..GGGCGG
#############.######
