.--............---..
..........G.........
....G..------.......
...--..........--...
.................G..
####..G.G.G.G....###
.......G.G.GCG......
......--------......
...--...........--..
............##......
...G....C..........X
...#...###.......###
....................
.1..GGGGGGGG..GGGCGG
##..##.##.#.#.######
