....................
.......C..G.C....G..
.......######....-.G
.C.................-
.###................
....................
......G..C.C....X..G
.#....-..###....#..G
...................G
.##....C.C.........G
.....#.###......#..G
.1.....C....C.GGGCG.
.####..######.#####.
...##..######......#
.......###..........
