....................
....................
....................
....G...##....#.....
....#....#C..C#.....
..........#####.....
......G.......#.....
......#.......#.....
.........#####......
.....#.......#......
.....C.C......#.....
.....###...G..#.....
...........#..#....X
.....C.GG....1#....#
.....####....##.....